##############
#............#
#............#
#......####..#
#......#..#..#
#.........#..#
##############