##############
#....~~~~....#
#....~~~~....#
#......####..#
#......#..#..#
#.........#..#
##############